0000000000000000
0000000000000000
0000000000000000
0000000000000000
0000001110000000
0000001210000000
0000001011110000
0000111303210000
0000120341110000
0000111131000000
0000000121000000
0000000111000000
0000000000000000
0000000000000000
0000000000000000
0000000000000000