0000000000000000
0000000000000000
0000000000000000
0000000000000000
0000000000000000
0000001111110000
0000001000010000
0000111333010000
0000140322010000
0000103222110000
0000111100100000
0000000111100000
0000000000000000
0000000000000000
0000000000000000
0000000000000000