0000000000000000
0000000000000000
0000000001111100
0000000010000010
0000000100311001
0000001001000301
1001001010010101
0101001030300301
0011111110131001
0010030300000010
0014223055211100
0001222222111110
0000111111111111
0000000000000000
0000000000000000
0000000000000000
