0000000000000000
0000000000000000
0000000000000000
0000000000000000
0000001111000000
0000001221000000
0000011021100000
0000010032100000
0000110300110000
0000100133010000
0000100400010000
0000111111110000
0000000000000000
0000000000000000
0000000000000000
0000000000000000