0000000000000000
0000000000000000
0000000000000000
0000000000000000
0000111111110000
0000100100010000
0000103223010000
0000143250110000
0000103223010000
0000100100010000
0000111111110000
0000000000000000
0000000000000000
0000000000000000
0000000000000000
0000000000000000