0000000000000000
0000000000000000
0000000000000000
0000000000000000
0000011111110000
0000110000100000
0000103033010000
0000122222210000
0000103303010000
0000111041110000
0000001111000000
0000000000000000
0000000000000000
0000000000000000
0000000000000000
0000000000000000