0000000000000000
0000000000000000
0000000000000000
0000111111000000
0000100001110000
0000103000010000
0011103011010000
0012220300010000
0012223130110000
0011110103010000
0000010040010000
0000011111110000
0000000000000000
0000000000000000
0000000000000000
0000000000000000