0000000000000000
0000000000000000
0000000000000000
0000000000000000
0001111110000000
0001000010000000
0001033311000000
0001001221110000
0001100223010000
0000104000010000
0000111111110000
0000000000000000
0000000000000000
0000000000000000
0000000000000000
0000000000000000