0000000000000000
0000000000000000
0000000000000000
0000000000000000
0000011111111000
0000010001201000
0000110032221000
0000100301521000
0001101131011000
0001000300301000
0001000100001000
0001111111401000
0000000001111000
0000000000000000
0000000000000000
0000000000000000