0000000000000000
0000000000000000
0000000000000000
0000000000000000
0000111111100000
0000122220100000
0001112223111000
0001003130301000
0001033001301000
0001000010001000
0001111040111000
0000001111100000
0000000000000000
0000000000000000
0000000000000000
0000000000000000