0000000000000000
0000000000000000
0000000000000000
0000111110000000
0000140010000000
0000103310111000
0000103010121000
0000111011121000
0000011000021000
0000010001001000
0000010001111000
0000011111000000
0000000000000000
0000000000000000
0000000000000000
0000000000000000