0000000000000000
0000000000000000
0000000000000000
0000000000000000
0000011111100000
0000010222100000
0011112222100000
0010011130111000
0010303003301000
0014030300001000
0010001110001000
0011111011111000
0000000000000000
0000000000000000
0000000000000000
0000000000000000