0000000000000000
0000000000000000
0000000000000000
0000111111110000
0000100000010000
0000101330010000
0000102221010000
0000112223011000
0000010110301000
0000013003001000
0000010010041000
0000011111111000
0000000000000000
0000000000000000
0000000000000000
0000000000000000