0000000000000000
0000000000000000
0000000000000000
0000000000000000
0000011111000000
0001110001111000
0001000303001000
0001030003041000
0001113311111000
0000010022100000
0000012222100000
0000011111100000
0000000000000000
0000000000000000
0000000000000000
0000000000000000