0000000000000000
0000000000000000
0000000000000000
0111111000111110
0100001110100210
0100303010122210
0101003011100210
0100333000304210
0111003003100210
0001003130122210
0001100000100210
0000111111111110
0000000000000000
0000000000000000
0000000000000000
0000000000000000