0000000000000000
0000000000000000
0001111111110000
0001000110011110
0001030000000010
0001131110110010
0001001105010110
0001032222220100
0011011102010100
0010000031113100
0010001000034100
0011111310111100
0000001000100000
0000001111100000
0000000000000000
0000000000000000