0000000000000000
0000111100000000
1111100100000000
1003030101111111
1000300101525251
1103030111252521
0130300100525251
0143030000252511
0130300100525251
1103030111252521
1000300101525251
1003030101111111
1111100100000000
0000111100000000
0000000000000000
0000000000000000