0000000000000000
0000000000000000
0000000000000000
0000000000000000
0000111111110000
0000122222210000
0000100301011000
0000103010301000
0000113030301000
0000010040001000
0000011111111000
0000000000000000
0000000000000000
0000000000000000
0000000000000000
0000000000000000