0000000000000000
0000000000000000
0000000000000000
0000000000000000
0000111111100000
0000100000111000
0001131110001000
0001040300301000
0001022103011000
0001122100010000
0000111111110000
0000000000000000
0000000000000000
0000000000000000
0000000000000000
0000000000000000