0000000000000000
0000000000000000
0000000000000000
0000000000000000
0000111111111100
0011100020000100
0010001131100100
0010432020231100
0011031131101000
0001000020001000
0001111111111000
0000000000000000
0000000000000000
0000000000000000
0000000000000000
0000000000000000