0000000000000000
0000000000000000
0000000000000000
0000000111111000
0000111120041000
0000100333001000
0000121121121000
0000100030001000
0000100321011000
0000111100010000
0000000111110000
0000000000000000
0000000000000000
0000000000000000
0000000000000000
0000000000000000