0000000000000000
0000000000000000
0000000000000000
0000000000000000
0000111111000000
0000120221000000
0000120321000000
0001110031100000
0001030030100000
0001013110100000
0001000400100000
0001111111100000
0000000000000000
0000000000000000
0000000000000000
0000000000000000