0000000000000000
0000000000000000
0000011111100000
0001110000111000
0001000130001110
0001000300033010
0001033013000010
0001100030003010
0111111013111110
0122401300100000
0121220031100000
0122223101000000
0122220001000000
0111111111000000
0000000000000000
0000000000000000