0000000000000000
1111111111111110
1000000100000010
1030130103113010
1010030100000010
1000113131133010
1010102220100010
1030020102301010
1031432221010010
1000020102003010
1011231113201010
1010322222011010
1000000000000010
1111111111111110
0000000000000000
0000000000000000