0000000000000000
0000000000000000
0000000000000000
0000000000000000
0000000111110000
0000000104010000
0000000133310000
0000111100010000
0000100021311000
0000103232021000
0000100121211000
0000111111110000
0000000000000000
0000000000000000
0000000000000000
0000000000000000