0000000000000000
0011111111111100
0012220100000100
0012200101100100
0012200000100100
0012200103110100
0012220130300100
0011111100330100
0001100303300100
0001403330010100
0001103011000100
0000100000000100
0000111111111100
0000000000000000
0000000000000000
0000000000000000