0000000000000000
0000000000000000
0000000000000000
0001111111110000
0001000000010000
0001003030310000
0001101311010000
0000102202211000
0000112202201000
0000010113101100
0000013030300100
0000010000004100
0000011111111100
0000000000000000
0000000000000000
0000000000000000