0000000000000000
0000000000000000
0000000000000000
0000000000000000
0000011110000000
0000110010000000
0000143010000000
0000113011000000
0000110301000000
0000123001000000
0000122521000000
0000111111000000
0000000000000000
0000000000000000
0000000000000000
0000000000000000