0000000000000000
1111100000011110
1400111111110010
1103000000030010
0101010011110010
0100300011113110
0130110103030100
1103003100000100
1000100000010100
1000111113111100
1111100010001000
0000122200301000
0000122221001000
0000122221111000
0000111111000000
0000000000000000