0000000000000000
0000000000000000
0000000000000000
0000000000000000
0000000011111000
0000111110001000
0000102203101000
0000101250001000
0001105213011000
0001030030010000
0001000110410000
0001111111110000
0000000000000000
0000000000000000
0000000000000000
0000000000000000