0000000000000000
0000000000000000
0000000000000000
0011111011111110
0010001110010010
0010300000304010
0011013112110010
0001002225203010
0001031012101010
0001100003000010
0000100111111110
0000111100000000
0000000000000000
0000000000000000
0000000000000000
0000000000000000