0000000000000000
0000000001110000
0000111111411000
0000122221301100
0000122221030100
0000122220300100
0000102221000100
1111110111110110
1030300030010010
1000033000303010
1110303030011110
0011000303010000
0001001111110000
0001111000000000
0000000000000000
0000000000000000