0000000000000000
0000000000000000
0000011111000000
0001110001110000
0011004303010000
0010011011011000
0010321230001000
0010121510001000
0010322200111000
0011131011100000
0000100010000000
0000111110000000
0000000000000000
0000000000000000
0000000000000000
0000000000000000