0000000000000000
0000000000000000
0000001111000000
0000001001111110
0000001000010010
0000001033000010
1111111310010010
1001202201113110
1001215230000010
1001212510100010
1033222210111110
1043010110100000
1033310000100000
1000011111100000
1111110000000000
0000000000000000