0000000000000000
1111000000000000
1001110000000000
1030011100000000
1030300111000000
1030303001110000
1030303000010000
1030300100011000
1030011033301000
1401111000001100
1101012333332100
0101112222222110
0100025555555210
0111122222222210
0000111111111110
0000000000000000