0000000000000000
0000000000000000
0000000000000000
0011111110000000
0010410011111000
0010330030001000
0010012113101000
0011312220001000
0011022211311000
0010011211001000
0010030030001000
0010010001001000
0011111111111000
0000000000000000
0000000000000000
0000000000000000