0000000000000000
0000000000000000
0000000000000000
0000011111000000
0000010401000000
0000010301000000
0000013231000000
0001112321100000
0011023232111000
0010032323001000
0010000200001000
0011111111111000
0000000000000000
0000000000000000
0000000000000000
0000000000000000