0000000000000000
0000000000000000
0011111111111110
0010030303252210
0010303030522210
0010030303252210
0010303030522210
0010030303252210
0010303030522210
0010030303252210
0010303030522210
0010030303252210
0014303030522210
0011111111111110
0000000000000000
0000000000000000