0000000000000000
0000000000000000
0000000000000000
0000011111000000
0000014011100000
0000010300100000
0000111010110000
0000121010010000
0000123001010000
0000120003010000
0000111111110000
0000000000000000
0000000000000000
0000000000000000
0000000000000000
0000000000000000