0000000000000000
0000000000000100
0000000000001100
0000000000011100
0000000000100010
0001111111101010
0010303030300010
0110121212143100
1112222222000110
0110101010131100
0010303030300010
0001111111101010
0000000000100010
0000000000011100
0000000000001100
0000000000000000