0000000000000000
0000000000000000
0000000000000000
0000000000000000
0001111111000000
0001002301110000
0001023230010000
0001532324010000
0001023230110000
0001002300100000
0001111111100000
0000000000000000
0000000000000000
0000000000000000
0000000000000000
0000000000000000