0000000000000000
0000000000000000
0000000000000000
0000000001111100
0000000001000100
1111111111050111
1000000000020001
1033335555322241
1000000000020001
1111111111050111
0000000001000100
0000000001111100
0000000000000000
0000000000000000
0000000000000000
0000000000000000