0000000000000000
0000000000000000
0000000000000000
0000000111100000
0011111100111110
0014300003003010
0013111030101010
0010010010300010
0010310000101110
0010030131000100
0012222222220100
0011111111000100
0000000001111100
0000000000000000
0000000000000000
0000000000000000