0000000000000000
0000000000000000
0000000000000000
0011111111111000
0010000100001000
0010343333301000
0010000000001000
0011111011111000
0000012001000000
0000012001000000
0000012221000000
0000012001000000
0000011111000000
0000000000000000
0000000000000000
0000000000000000