0000000000000000
0000000000000000
0000111110000000
0000104010000000
0000103010000000
0011102011100000
0010005000100000
0010555550100000
0010005000100000
0011135311100000
0000102010000000
0000105010000000
0000102010000000
0000111110000000
0000000000000000
0000000000000000