0000000000000000
0000000000000000
0111111111111110
0120000000000010
0123030303030010
0121111111110010
0121250302235110
0121030305234100
0121200302233100
0121111111112100
0120000000000100
0121313131313100
0120000000000100
0111111111111100
0000000000000000
0000000000000000