0000000000000000
0000000000000000
0000000000000000
0111111111111000
0122001000001110
0122001030030010
0122001311110010
0122000040110010
0122001010030110
0111111011303010
0001030030303010
0001000010000010
0001111111111110
0000000000000000
0000000000000000
0000000000000000