0000000000000000
0000000011110000
0111111110011110
0100011222220010
0100300112221010
0110030011101010
0010103001000010
0010010300100010
0010001030010010
0010000103010110
0011110010300100
0000011001030100
0000001141000100
0000000111111100
0000000000000000
0000000000000000