0000000000000000
0000000000000000
0000000000000000
0111100000011110
0122111111112210
0152522222525210
0103030303030310
0130303430303010
0103030303030310
0130303030303010
0125252222252510
0122111111112210
0111100000011110
0000000000000000
0000000000000000
0000000000000000