0000000000000000
0000000000000000
0000000000000000
0000001111100000
0000011000111100
0000010025030100
0011110121000100
0010000252141100
0010101131101000
0010000030301000
0011001000111000
0001111111100000
0000000000000000
0000000000000000
0000000000000000
0000000000000000