0000000000000000
0000000000000000
0000000000000000
0000000000000000
0001111110000000
0001000010000000
0001030011110000
0001035225010000
0001052253010000
0001111003010000
0000001040010000
0000001111110000
0000000000000000
0000000000000000
0000000000000000
0000000000000000