0000000000000000
0000000000000000
0000000000000000
0000000000000000
0000001111100000
0001111200110000
0001032320010000
0001431013010000
0001032020010000
0001111313010000
0000012020010000
0000011111110000
0000000000000000
0000000000000000
0000000000000000
0000000000000000