0000000000000000
0000000000000000
0000000000000000
0000000000000000
0000000000000000
0011111111111100
0010000222030100
0010333555034100
0010000222030100
0011111111111100
0000000000000000
0000000000000000
0000000000000000
0000000000000000
0000000000000000
0000000000000000