0000000000000000
0000000000000000
0000000000000000
0000000000000000
0000000000000000
0001111111111000
0001100000001000
0001000131301000
0001033002321000
0001041112221000
0001111111111000
0000000000000000
0000000000000000
0000000000000000
0000000000000000
0000000000000000