0000000000000000
0000000000000000
0000000000000000
0001111000000000
0001001111100000
0011301100100000
0010034300100000
0010001130100000
0011121101110000
0001222303010000
0001122000010000
0000111111110000
0000000000000000
0000000000000000
0000000000000000
0000000000000000