0000000000000000
0000000000000000
0000000011110000
0011111110010000
0010000030010000
0010003114310000
0011312221010000
0001032220010000
0001012021011000
0001000101301000
0001300300001000
0001001111111000
0001111000000000
0000000000000000
0000000000000000
0000000000000000