0000000000000000
0000000000000000
0000000000000000
0000000000000000
0000000000000000
0000001111111000
0000011001041000
0000010001001000
0000013030301000
0000010311001000
0001110301011000
0001222220010000
0001111111110000
0000000000000000
0000000000000000
0000000000000000