0000000000000000
0000000000000000
0000000000000000
0000011111111100
0000010001000100
0000010000000100
0011111511101100
0010002220001000
0010101511131100
0010300003000100
0011111401000100
0000001111111100
0000000000000000
0000000000000000
0000000000000000
0000000000000000