0000000000000000
1111100000000000
1222101111100000
1222111000100000
1222200033111110
1222200100100011
1221311110131001
1103001000003301
1003104030331001
1030303010003011
1000100301100010
1111110001111110
0000011111000000
0000000000000000
0000000000000000
0000000000000000