0000000000000000
0000000000000000
1111111111111110
1112100000011110
1122103003010010
1222101103010010
1222220013300010
1122223000013010
1111011111110010
1000300000000110
1003010031030110
1031110301033010
1000410011000010
1111111111111110
0000000000000000
0000000000000000