0000000000000000
0000000000000000
0000000111111110
0000000100100010
0111111103322210
0100000000122210
0101111113122210
1101000000122210
1001013030111110
1010303030100000
1040030100100000
1111130330100000
0000100000100000
0000111111100000
0000000000000000
0000000000000000