0000000000000000
0000000000000000
0000000001111100
0000111111000100
0011100002030100
0010300132131100
0010010042100100
0011011112000100
0001030015111100
0001011012001000
0001000002101000
0001113000001000
0000010011111000
0000011110000000
0000000000000000
0000000000000000