0000000000000000
0000000000000000
0000000000000000
0000001111000000
0011111001111100
0010000300030100
0010031311000100
0011101252011100
0000102220410000
0000110131110000
0000010001000000
0000011111000000
0000000000000000
0000000000000000
0000000000000000
0000000000000000