0000000000000000
0000000000000000
0000000000000000
0000000000000000
0000001111111100
0001111000020100
0001003030320100
0001002111121100
0001032303041000
0001002001111000
0001111111000000
0000000000000000
0000000000000000
0000000000000000
0000000000000000
0000000000000000