0000000000000000
0000000000000000
0000000000000000
0000111110000000
0000100010000000
0011132311111000
0010002030001000
0010113110401000
0010002011111000
0011102010000000
0000100010000000
0000111110000000
0000000000000000
0000000000000000
0000000000000000
0000000000000000