0000000000000000
0000000000000000
0000000000000000
0000111110000000
0000104011111100
0000101225000100
0000102221000100
0001131103030100
0001000131111100
0001000300010000
0001111101010000
0000000100010000
0000000111110000
0000000000000000
0000000000000000
0000000000000000