0000000000000000
0000001111110000
0000111000011000
0000100011001000
0011131100101000
0110000022101000
0100313152101000
0103340125101110
0100330122100010
0110000122300010
0011131120101110
0000100111001000
0000110000011000
0000011111110000
0000000000000000
0000000000000000