0000000000000000
0000000000000000
0000000000000000
0000000000000000
0000001111110000
0000111000010000
0001120311011000
0001223030041000
0001220303011000
0001111110010000
0000000011110000
0000000000000000
0000000000000000
0000000000000000
0000000000000000
0000000000000000