0000000000000000
0000000000000000
0000001111111000
0000001001001000
0000001003301000
0111111031001000
0122211101001100
0120010030100100
0120000303030100
0120010030100100
0122211101001100
0111111030001000
0000001401001000
0000001111111000
0000000000000000
0000000000000000