0000000000000000
0000000000111111
0000000000100001
1111100011101101
1220111110300101
1220000030003101
1220011011000101
1220110301303101
1220100000300101
1220100301113001
1220103030030111
1110110103000010
0010000141103010
0011111111100110
0000000000111100
0000000000000000