0000000000000000
0000000000000000
0000000000000000
0000000100000000
0000011111000000
0001110401110000
0001003030010000
0001052525010000
0011023032011000
0111052525011100
1111003030011110
0001111110010000
0000110001100000
0000000000000000
0000000000000000
0000000000000000