0000000000000000
0111111111111110
0104050505010011
0131005050010001
0101050505000001
0101005050011011
0101050505011010
0101005050011010
0101050505011010
0101005050011010
0101050205011011
1101111111111001
1000000000000001
1000111111111001
1111100000001111
0000000000000000