0000000000000000
0000000000000000
0000000000000000
0011111111111110
0010000100110010
0013330103300311
0010300100222201
0010030013211201
0010010310222211
0113030013211201
0103003043222201
0100011100111111
0111110111100000
0000000000000000
0000000000000000
0000000000000000