0000000000000000
0000001111111110
0000001000000010
0000001003131010
0011111100103010
0010001030030010
0110300000111010
0100013111100010
0100003011101110
0111112204101100
0000122230330100
0000122210000100
0000122211111100
0000111110000000
0000000000000000
0000000000000000