0000000000000000
1111000001111000
1001111111221110
1030303001222210
1030003301555210
1030303001225210
1003030301525210
1103030302525211
1003030302525241
1003030301525211
1030303001225210
1030003301555210
1030303001222210
1001111111221110
1111000001111000
0000000000000000