0000000000000000
0000001111100000
1111111000100000
1000112000100000
1003122001110000
1100222133011111
0103212300000001
0103111311010301
0100010000033101
0113310113130001
0122203403000111
0122213100011100
0122200111110000
0111111100000000
0000000000000000
0000000000000000