0000000000000000
0000000000000000
0001111001111110
0001001111000010
0011500050550010
0010305000051010
0010200011100010
0011111100014110
0010502050055010
0010001000100010
0011500050131010
0001001111100010
0001111000111110
0000000000000000
0000000000000000
0000000000000000