0000000000000000
0000000000000000
0000000000000000
0000000000000000
0000111111111000
0000100010001000
0000103333301000
0001103030301000
0001030040001000
0001030111101100
0001001222220100
0001100222220100
0000111111111100
0000000000000000
0000000000000000
0000000000000000