0000000000000000
0000000000000000
0001111111000000
0001000001000000
0001030301100000
0001111122111110
1111112252003010
1003432222133010
1000301311100010
1111100000001110
0000111001111000
0000001001000000
0000001111000000
0000000000000000
0000000000000000
0000000000000000