0000000000000000
0000000000000000
0000000000000000
0000000000000000
0001111100000000
0001000111111000
0001030220301000
0001130223341000
0000100220301000
0000111111111000
0000000000000000
0000000000000000
0000000000000000
0000000000000000
0000000000000000
0000000000000000