0000000000000000
0000000000000000
0000000000000000
0000000000000000
0000111110000000
0000100011111100
0011131200000100
0010302221030100
0014032153000100
0011110000111100
0000011111100000
0000000000000000
0000000000000000
0000000000000000
0000000000000000
0000000000000000