0000000000000000
0000000000000000
0000111110000000
1111100010000000
1000304010000000
1003012111110000
1130112110011110
0100222220310010
0103112110013010
0100012110000010
0111030111110110
0001013000003010
0001000011100010
0001111110111110
0000000000000000
0000000000000000