0000000000000000
0000000000000000
0000000000000000
0000111111100000
0000100500100000
0000104230100000
0000103200100000
0000152555100000
0000100500100000
0000103530100000
0000100200100000
0000111111100000
0000000000000000
0000000000000000
0000000000000000
0000000000000000