0000000000000000
0011111111100000
0010000100100000
1110130030111100
1003001122100111
1010030122303001
1033003122001001
1100100222130001
0130401222103001
0100001222300011
0101130111000110
0100030000011100
0100111111110000
0111100000000000
0000000000000000
0000000000000000