0000000000000000
0000111111111100
0111122222200100
0100022222100100
0100122222201100
0110111131131000
0143003030001110
0103300001100010
0101003311001010
0100030010330010
0100300300013010
0111100010303010
0000100010000010
0000111111111110
0000000000000000
0000000000000000