0000000000000000
0000001111111110
0000001000000010
0000001303330010
0000001000103010
0000001000343010
0000111303010110
0000100031310100
1111101001000100
1222001031011100
1222220001010000
1222221031010000
1111111100010000
0000000111110000
0000000000000000
0000000000000000