0000000000000000
0000000000000000
0011111011111100
0010001110000100
0110303013013100
0100304030030110
0101001101222210
0100110301211210
0110030000222210
0010330131222210
0010001000130110
0011111030000100
0000001111001100
0000000001111000
0000000000000000
0000000000000000