0000000000000000
1111000000000000
1001000000000000
1001111111111000
1000011000001000
1221000033101000
1220011000301110
1221001131030010
1220001043030010
1221001030300010
1020001030301110
1001001000111000
1001000011100000
1111111110000000
0000000000000000
0000000000000000